11111111111111111111111111
1111100C00P000C000000000E1
100000000C0000C00000000001
100000000C0000C00000000001
100000000C0000C00000000001
100000000C0000C00000000001
100000000C0000C00000000001
100000000C0000C00000000001
100000000C0000C00000000001
100000000C0000C00000000001
100000000C0000C00000000001
100000000C0000C00000000001
100000000C0000C00000000001
100000000C0000C00000000001
100000000C0000C00000000001
100000000C0000C00000000001
100000000C0000C00000000001
100000000C0000C00000000001
100000000C0000C00000000001
11111111111111111111111111